48
48
78,78,78,78,78,78,78,78,78,78,78,78,78,78,78,78,78,78,78,78,78,78,78,78,78,78,78,78,78,78,78,78,78,78,78,78,78,78,78,78,78,78,78,78,78,78,78,78
78,-113,-108,-109,-108,-109,-108,-109,-108,-109,-108,-109,-108,-109,-108,-109,-108,-109,-108,-109,-108,-109,-108,-109,-108,-109,-108,-109,-108,-109,-108,-109,-108,-109,-108,-109,-108,-109,-108,-109,-108,-109,-108,-109,-108,-109,-112,78
78,-133,78,78,78,78,78,78,78,78,78,78,78,78,78,78,78,78,78,78,78,78,78,78,78,78,78,78,78,78,78,78,78,78,78,78,78,78,78,78,78,78,78,78,78,78,-133,78
78,-133,78,78,78,78,78,78,78,78,78,78,78,78,78,78,78,78,78,78,78,78,78,78,50,-8,-9,-10,50,78,78,78,78,78,78,78,78,78,78,78,78,78,78,78,78,78,-133,78
78,-133,78,78,78,78,78,78,78,78,78,78,78,78,78,78,78,78,78,78,78,78,78,78,78,-20,-21,-22,78,78,78,78,78,78,78,78,78,78,78,78,78,78,78,78,78,78,-133,78
78,-133,78,50,-8,-9,-10,50,78,78,78,78,78,78,78,78,78,78,78,78,78,78,78,78,78,-32,-33,-34,78,78,78,78,78,78,78,78,78,78,78,78,78,78,78,78,78,78,-133,78
78,-133,78,78,-20,-21,-22,78,78,78,78,78,78,78,78,78,78,78,78,78,78,78,78,78,50,-44,-45,-46,50,78,78,78,78,78,78,78,78,78,78,78,78,78,78,78,78,78,-133,78
78,-133,78,78,-32,-33,-34,78,78,78,78,78,78,78,78,78,78,78,78,78,78,78,78,78,78,78,84,78,78,78,78,78,78,78,78,78,78,78,78,78,78,78,78,78,78,78,-133,78
78,-133,78,50,-44,-45,-46,50,78,78,78,78,78,78,78,78,78,78,78,78,78,78,78,78,78,84,84,84,78,78,78,78,78,78,78,78,78,78,78,78,78,78,78,78,78,78,-133,78
78,-133,78,78,78,84,78,78,78,78,78,78,78,78,78,78,78,78,78,78,78,78,78,78,78,84,84,84,78,78,78,78,78,78,78,78,78,78,78,78,78,78,78,78,78,78,-133,78
78,-133,78,78,84,84,84,78,78,78,78,78,78,78,78,78,78,78,78,78,78,78,78,78,78,84,84,84,78,78,78,78,78,78,78,78,78,78,78,78,78,78,78,78,78,78,-133,78
78,-133,78,78,78,84,84,78,78,78,78,78,78,78,78,78,78,78,78,78,78,78,78,78,84,84,84,78,78,78,78,78,78,78,78,78,78,78,78,78,78,78,78,78,78,78,-133,78
78,-133,78,78,78,78,84,84,78,78,78,78,78,78,78,78,78,78,78,78,78,78,78,84,84,84,78,78,78,78,78,78,78,78,78,78,78,78,78,78,78,78,78,78,78,78,-133,78
78,-133,78,78,78,78,78,84,84,78,78,78,78,78,78,78,78,78,78,78,78,78,78,84,84,84,78,78,78,78,78,78,78,78,50,-8,-9,-10,50,78,78,78,78,78,78,78,-133,78
78,-133,78,78,78,78,78,84,84,84,78,78,78,78,78,78,78,78,78,78,78,78,78,84,84,84,78,78,78,78,78,78,78,78,78,-20,-21,-22,78,78,78,78,78,78,78,78,-133,78
78,-133,78,78,78,78,78,78,78,84,84,78,78,78,78,78,78,78,78,78,78,78,78,84,84,78,78,78,78,78,78,78,78,78,78,-32,-33,-34,78,78,78,78,78,78,78,78,-133,78
78,-133,78,78,78,78,78,78,78,84,84,84,78,78,78,78,78,78,78,78,78,78,84,84,84,78,78,78,78,78,78,78,78,78,50,-44,-45,-46,50,78,78,78,78,78,78,78,-133,78
78,-133,78,78,78,78,78,78,78,78,78,84,84,78,78,78,78,78,78,78,78,78,84,84,78,78,78,78,78,78,78,78,78,78,78,78,84,78,78,78,78,78,78,78,78,78,-133,78
78,-133,78,78,78,78,78,78,78,78,78,78,84,84,78,78,78,78,78,78,78,84,84,84,78,78,78,78,78,78,78,78,78,84,84,84,84,78,78,78,78,78,78,78,78,78,-133,78
78,-133,78,78,78,78,78,78,78,78,78,78,84,84,78,78,84,78,78,78,84,84,84,78,78,78,78,78,84,78,78,84,84,84,84,84,78,78,78,78,78,78,78,78,78,78,-133,78
78,-133,78,78,78,78,78,78,78,78,78,78,78,84,84,84,84,84,78,84,84,84,84,84,78,84,78,84,84,84,84,84,84,78,78,78,78,78,78,78,78,78,78,78,78,78,-133,78
78,-133,78,78,78,78,78,78,78,78,78,78,78,78,84,84,84,84,84,84,84,84,84,84,84,84,84,84,84,84,84,78,78,78,78,78,78,78,78,78,78,78,78,78,78,78,-133,78
78,-133,78,78,78,78,78,78,78,78,78,78,78,78,78,84,84,84,84,84,84,84,84,84,84,84,84,84,84,84,78,78,78,78,78,78,78,78,78,78,78,78,78,78,78,78,-133,78
78,-133,78,78,78,78,78,78,78,78,78,78,78,78,78,78,84,84,84,84,84,84,84,84,84,84,84,84,78,78,78,78,78,78,78,78,78,78,78,78,78,78,78,78,78,78,-133,78
78,-133,78,78,78,78,78,78,78,78,78,78,78,78,78,84,84,84,84,84,84,84,84,84,84,84,84,84,78,78,78,78,78,78,78,78,78,78,78,78,78,78,78,78,78,78,-133,78
78,-133,78,78,78,78,78,78,78,78,78,78,78,78,78,78,84,84,84,84,84,84,84,84,84,84,84,84,84,78,78,78,78,78,78,78,78,78,78,78,78,78,78,78,78,78,-133,78
78,-133,78,78,78,78,78,78,78,78,78,78,78,78,78,84,84,84,84,84,84,84,84,84,84,84,84,78,78,78,78,78,78,78,78,78,78,78,78,78,78,78,78,78,78,78,-133,78
78,-133,78,78,78,78,78,78,78,78,78,78,78,78,78,78,78,84,84,84,84,84,84,84,84,84,84,84,78,78,78,78,78,78,78,78,78,78,78,78,78,78,78,78,78,78,-133,78
78,-133,78,78,78,78,78,78,78,78,78,78,78,78,78,78,84,84,84,84,84,84,84,84,84,84,84,84,84,78,78,78,78,78,78,78,78,78,78,78,78,78,78,78,78,78,-133,78
78,-133,78,78,78,50,-8,-9,-10,50,78,78,78,78,78,84,84,84,84,84,84,84,84,84,84,78,84,84,78,78,78,78,78,78,78,78,78,78,78,78,78,78,78,78,78,78,-133,78
78,-133,78,78,78,78,-20,-21,-22,78,78,78,78,78,84,84,84,84,84,84,84,84,84,84,78,78,78,78,78,78,78,78,78,78,78,78,78,78,78,78,78,78,78,78,78,78,-133,78
78,-133,78,78,78,78,-32,-33,-34,78,78,78,78,84,84,84,78,78,78,78,84,84,84,78,78,78,78,78,78,78,78,78,78,78,78,78,78,78,78,78,78,78,78,78,78,78,-133,78
78,-133,78,78,78,50,-44,-45,-46,50,78,78,78,84,84,78,78,78,78,78,78,84,84,78,78,78,78,78,78,78,78,78,78,78,78,78,78,78,78,78,78,78,78,78,78,78,-133,78
78,-133,78,78,78,78,78,84,78,78,84,84,84,84,84,78,78,78,78,78,78,78,84,84,84,78,78,78,78,78,78,78,78,78,78,78,78,78,78,78,78,78,78,78,78,78,-133,78
78,-133,78,78,78,78,78,84,84,84,84,84,84,84,78,78,78,78,78,78,78,78,78,84,84,84,78,78,78,78,78,78,78,78,78,78,78,78,78,78,78,78,78,78,78,78,-133,78
78,-133,78,78,78,78,78,78,84,84,84,78,78,78,78,78,78,78,78,78,78,78,78,78,84,84,84,78,78,78,78,78,78,78,78,78,78,78,78,78,78,78,78,78,78,78,-133,78
78,-133,78,78,78,78,78,78,78,78,78,78,78,78,78,78,78,78,78,78,78,78,78,78,78,84,84,84,78,78,78,78,78,78,78,78,78,78,78,78,78,78,78,78,78,78,-133,78
78,-133,78,78,78,78,78,78,78,78,78,78,78,78,78,78,78,78,78,78,78,78,78,78,78,78,84,84,84,78,78,78,78,78,78,78,78,78,78,78,78,78,78,78,78,78,-133,78
78,-133,78,78,78,78,78,78,78,78,78,78,78,78,78,78,78,78,78,78,78,78,78,78,78,78,78,84,84,84,78,78,78,78,78,78,78,78,78,78,78,78,78,78,78,78,-133,78
78,-133,78,78,78,78,78,78,78,78,78,78,78,78,78,78,78,78,78,78,78,78,78,78,78,78,78,78,84,84,84,78,78,78,78,78,78,78,78,78,78,78,78,78,78,78,-133,78
78,-133,78,78,78,78,78,78,78,78,78,78,78,78,78,78,78,78,78,78,78,78,78,78,78,78,78,78,78,84,84,84,78,78,78,78,78,78,78,78,78,78,78,78,78,78,-133,78
78,-133,78,78,78,78,78,78,78,78,78,78,78,78,78,78,78,78,78,78,78,78,78,78,78,78,78,78,78,78,84,84,84,78,78,78,78,78,78,78,78,78,78,78,78,78,-133,78
78,-133,78,78,78,78,78,78,78,78,78,78,78,78,78,78,78,78,78,78,78,78,78,78,78,78,78,78,78,78,78,84,84,84,78,78,78,50,-8,-9,-10,50,78,78,78,78,-133,78
78,-133,78,78,78,78,78,78,78,78,78,78,78,78,78,78,78,78,78,78,78,78,78,78,78,78,78,78,78,78,78,78,84,84,78,78,78,78,-20,-21,-22,78,78,78,78,78,-133,78
78,-133,78,78,78,78,78,78,78,78,78,78,78,78,78,78,78,78,78,78,78,78,78,78,78,78,78,78,78,78,78,78,78,84,84,78,78,78,-32,-33,-34,78,78,78,78,78,-133,78
78,-133,78,78,78,78,78,78,78,78,78,78,78,78,78,78,78,78,78,78,78,78,78,78,78,78,78,78,78,78,78,78,78,84,84,84,78,50,-44,-45,-46,50,78,78,78,78,-133,78
78,-133,78,78,78,78,78,78,78,78,78,78,78,78,78,78,78,78,78,78,78,78,78,78,78,78,78,78,78,78,78,78,78,78,84,84,84,84,84,84,78,78,78,78,78,78,-133,78
78,-113,-108,-109,-108,-109,-108,-109,-108,-109,-108,-109,-108,-109,-108,-109,-108,-109,-108,-109,-108,-109,-108,-109,-108,-109,-108,-109,-108,-109,-108,-109,-108,-109,-108,-109,-108,-109,-108,-109,-108,-109,-108,-109,-108,-109,-112,78